
R 1000             1000   
NO ./files/xpm_files/tiles_grey.xpm  

SO ./files/xpm_files/tile_blue.xpm  

WE           ./files/xpm_files/COVID.xpm     
 EA ./files/xpm_files/happy_pikachu.xpm      
S ./files/xpm_files/door_light_brown.xpm    
F 200,5,100
           C         96,30,0           






1111111 1111111 11111 1111111111111111111
1000001 1000001 10001 0102000000000000001
1001001 1001101 10011 0101110111000000001
1000001 1000001 10010 0101110111111101111
1000101 1000001 10111 0101112101111121111
100000111010101110001 1121110101111101111
10100000001010000000111001000001000000001
10000000000000000000020001000001000000001
111111101111111011111111011111010000000011
101111121111111211111 11211111011000000001
111111101111111011111111011111011000000001
111000000001000000000020000001001000S00001
111110000011111111101111111111011000000001
121 1000001 1000001010120001 1010000000011
101 1011101 1011101010111001 1011000000001
101 101 101 101 101010 11101 1010000000011
101 101 101 101 101010 1 101 101000000001
1011101 1011101 101010 1 1011101000000001
1000001 1000001 100010 1 1000000000000001
1111111111111111111111 111111111111111111




