R 0000000000876 1003
SO ./files/xpm_files/wood.xpm
WE ./files/xpm_files/colorstone.xpm          
NO ./files/xpm_files/mossy.xpm
EA ./files/xpm_files/redbrick.xpm

S ./files/xpm_files/monero_school_cut.xpm

    F        15,55,5
C 1,20,110



        1111111111111111111111111
        1000000000110000000000001
        1011002001110000002000001
        1001000000000020000000001
111111111011000001110000000000001
100000000011000001110111111111111
11110110011111011100000010001
11110111001111011101010010001
11000000110101002000020010001
10002000000000000000000010001
10020000000200000001010000001
11000001110101011111011110N0111
11112111 1110101 101111010001
11111111 1111111 111111111111




