R 0000000000876 1003
SO ./files/xpm_files/COVID.xpm
WE ./files/xpm_files/tile_blue.xpm          
NO ./files/xpm_files/tiles_grey.xpm
EA ./files/xpm_files/many_stripes_square.xpm 

S ./files/xpm_files/monero_school_cut.xpm

    F        160,120,50
C 2,155,231


1111111111111111111111111111111111111111111111
1100000000000000200000000000000000000000000011
1100000000000000000000000000000000000000000011
1100000000000000000000000000000000000000000011
110000000S000000000000000000000020000000000011
1100000000000000000000000000000000000000000011
1100000000000020000000000000000000200000000011
1100000000000000000000000000000000000000000011
1100000000000000000000000000000000000000000011
1100000000000000000000020000000000000000000011
1100000000000000000000000000000000000000000011
1100000000000000000000000000000000000000000011
1100000100000100000111011100000100000000000011
1100000000000000000120002100000000000000000011
1100000000000000000100000100000100000000000011
1100002000000000000000000000000000000000000011
1100000000000000000100000100000000000000000011
1100000000000000000120002100000000000000000011
1100000000000000000111011100000000000000000011
1100000000000000000000000000000000000000000011
1100000000000000000000000000000000000200000011
1100000000000000000000000000000000000000000011
1100000000000000000000000000000000000000000011
1111111111111111111111111111111111111111111111

